10 10 11 10 10 10 10 10 10 10 10 10 10 11 11 10
10 11 10 11 10 10 10 10 10 10 10 10 10 11 11 10
10 11 21 14 14 20 10 10 11 10 21 14 14 20 11 10
10 10 17 13 13 16 10 11 10 10 17 13 13 16 11 10
10 10 17 13 13 16 10 10 10 10 17 13 13 16 10 10
10 10 17 13 13 16 10 10 10 10 17 13 13 16 10 10
10 10 18 15 15 19 10 10 11 10 18 15 15 19 10 10
10 10 10 10 10 10 11 11 11 11 10 10 10 11 10 10
10 11 10 10 10 10 11 11 11 11 10 10 10 10 10 10
10 10 21 14 14 20 10 10 10 10 21 14 14 20 10 10
10 10 17 13 13 16 10 10 10 10 17 13 13 16 10 10
10 10 17 13 13 16 10 10 10 10 17 13 13 16 10 10
10 10 17 13 13 16 10 10 10 10 17 13 13 16 11 10
10 10 18 15 15 19 10 10 11 10 18 15 15 19 11 10
10 10 11 11 11 10 10 11 10 10 10 10 10 11 11 10
10 10 10 11 10 10 10 10 10 10 10 10 10 11 11 10